11111111111111111111
100000C000000E1
11P000000000000001
111111111111111111111