111111111111111111111
1111110000000000000E1
1C0000000000011C00001
111111111000011111111
1P000000Z0000000C0001
111111111111111111111