1111111111111111111
10000C00000C00000E1
100000000C000000001
1000000C00000000001
1C0000P000000000001
1111111111111111111
