1111111111111111111111111111111111111111111111111
1000000CCCCCCCE1000000000000000000000000000000111
11111111111011111000000000000000000C1111111111111
1000000000000000000000000000000000000000000000001
10000000001111111100000000000000000000000CC111111
10000000C0000000000000000000000011111111111111111
10000000000000011111111000000000011110000C0111111
1P000000000000000000C0000000000000000000000000001
1111111111111111111111111111111111111111111111111
